                       /\                             /\                     
                    __/  \     /\                   /\\/\\                   
                   /      \  _/  \                /\      \                  
                  /        \/     \              /           \               
                 /                 \            /             \              
                /                    \         /               \             
               /                     \        /                 \____        
              /                        \     /         __            \__     
             /                          \_  /         /  \              \    
            /                             \/_        |    |              \   
           /                                 \       |    |               \  
          /                                   \      |    |                \ 