frames 1
width 12
height 7
color white
 __________ 
|##########|
|##__##__##|
|#________#|
|#\______/#|
|##########|
 ---------- 
end
eof