frames 1
width 12
height 7
color green
 __________ 
|##########|
|####__####|
|#__####__#|
|##______##|
|##\____/##|
 ---------- 
end
eof