frames 1
width 12
height 7
color cyan
 __________ 
|##########|
|#_#_##_#_#|
|##_####_##|
|###____###|
|###\__/###|
 ---------- 
end
eof